.......#.#
#.#.##...#
##.....#.#
###.##.#.#
###.##.###
........#.
.#.##.#.#.
.#E##.#.#.
.#.#..#.##
.....##...
